**       ***************************************** 
** ***** *************************************** A  
** ***** *****                                   *  
** **   B**************************************  *
** ** ******** ********************************* *
** *           ********************************* *
** * ****                                        *
*         ****************************************

         B         
 ***************** 
 ***************   
 *************** **
 *   *********** **
A  *             **