         B         
 ***************** 
 ***************   
 *************** **
 *   *********** **
A  *             **